3
1
8	1	3	6	9	7	5	2	4
6	5	7	1	2	4	3	9	8
4	9	2	-1	8	5	-1	6	-1
2	7	6	4	5	8	1	3	9
3	8	9	2	1	6	4	7	5
-1	4	1	9	7	3	2	8	6
9	6	5	7	4	2	8	1	3
1	2	-1	-1	3	9	6	5	7
7	3	8	5	6	-1	9	4	2
